6,7,
1,1,1,1,1,1,
1,3,2,2,4,1,
1,3,2,2,4,1,
1,5,6,6,7,1,
1,8,9,10,11,1,
1,12,0,0,13,1,
1,1,-1,-1,1,1,